Player,Rating,Deviation,Games,Win,Draw,Loss,Lag,country
Brian White,2639.59924592189,112.238851868926,17,15,0,2,0,USA
Jay Larsen,2638.71328607144,151.872117543886,6,6,0,0,0,USA
Sheldon Pace,2635.977640955,149.913823583141,6,6,0,0,0,Australia
Colin Hill,2624.06075160867,161.868831197146,6,6,0,0,6,USA
William Cruickshanks,2599.1291062399,125.586319203951,12,11,0,1,0,Scotland
Aaron Wale,2598.3795237094,156.477761833633,6,5,0,1,0,Australia
Jaakko Uusitupa,2597.53443145198,108.08311435329,17,15,0,2,0,Finland
Peter Bates,2596.01475532092,181.0864120688,6,6,0,0,0,United.Nations
Keith Christianson,2585.98114623905,170.888304934827,5,5,0,0,12,USA
Sascha Maisel,2580.4495886011,155.146578360405,6,6,0,0,0,Germany
Johan Persson,2570.92066574492,174.022727711579,5,5,0,0,12,Sweden
Bubba Dalton,2554.8470222677,172.070008644969,6,6,0,0,0,United.Nations
Konrad Sosnowski,2552.25316283964,130.656658890485,12,11,0,1,0,Poland
Mikkel Ernst,2546.40999413427,155.911255292097,6,5,0,1,6,Denmark
Ben Leeper,2536.70541835435,123.908931857759,12,10,0,2,0,Australia
Alessandro Montagnani,2528.72917389276,126.536824338717,12,11,0,1,0,Italy
Adam Bell,2517.28345121513,156.107114198425,6,5,0,1,0,England
Tomasz Tutaj,2515.55543075065,112.923426572836,17,14,0,3,0,Poland
Patrick Dunford,2513.16565554579,125.509449110542,12,10,0,2,0,Ireland
David Potts,2512.10270105435,124.050393315109,12,10,0,2,0,Australia
Tom Guan,2511.54698914579,147.300183241051,6,5,0,1,0,USA
Marcin Mycek,2507.56371543588,110.017156581758,17,11,0,6,0,Poland
Robin Maukisch,2500.5778777199,108.015597707236,17,13,0,4,0,Germany
Daniele Diaspro,2495.63337782708,122.562711902193,12,9,0,3,0,Italy
David Beauchamp,2491.37398819871,147.641785566156,6,5,0,1,0,Canada
Fraser McFetridge,2487.46486865836,114.018281537782,12,8,0,4,0,Scotland
Kevin Aourragh,2484.23457937054,160.75076175487,6,5,0,1,0,France
Evan Ferris,2483.42718823323,154.693197114954,6,5,0,1,6,Australia
Dan Cunningham,2482.36873782052,116.223594181413,12,9,0,3,0,England
Will Pagani,2481.86523082337,114.559557559708,17,13,0,4,0,USA
Krzysztof Hawryszczuk,2474.00779293774,168.871002346151,6,5,0,1,0,Poland
Jan D'Souza,2473.69897260291,133.580470943794,11,9,0,2,6,Denmark
Mike Porter,2473.51182222696,163.640469945905,6,5,0,1,0,Ireland
Robert Cantrell,2472.8816947208,157.348550090583,6,5,0,1,6,Australia
Christoffer Wedding,2468.73499755539,112.947833086768,17,13,0,4,0,Sweden
Lewis Johnson,2464.13823868503,137.445380778311,11,9,0,2,6,England
Dario Stabellini,2460.79407684292,164.597507654958,6,5,0,1,6,Italy
Terry Slade,2460.75610600991,156.964069970642,6,5,0,1,0,Wales
Pavel Bednar,2455.45208209943,203.141594214052,3,3,0,0,13,Slovakia
Bryce Johnston,2455.10959848227,151.553790479239,6,4,0,2,0,Scotland
Matt Goligher,2453.62976555546,119.81095100092,12,10,0,2,0,England
Henry Hyttinen,2453.13683769335,155.502404669637,6,4,0,2,0,Finland
Aaron Thompson,2451.91446092082,114.294760766202,12,8,0,4,0,Australia
Trent Denison,2449.98315974801,119.272748750602,12,9,0,3,0,Australia
Charles Arrasmith,2447.64657840689,159.012811826968,6,4,0,2,6,USA
Chris Davies,2445.54920284963,200,0,0,0,0,0,Australia
Dimitri Sarbanis,2445.54920284963,200,0,0,0,0,0,Australia
Henry Wagner,2445.54920284963,200,0,0,0,0,0,Australia
Jack Ding,2445.54920284963,200,0,0,0,0,0,Australia
Josh Bates,2445.54920284963,200,0,0,0,0,0,Australia
Liam Gallagher,2445.54920284963,200,0,0,0,0,0,Australia
Rohan Mowle,2445.54920284963,200,0,0,0,0,0,Australia
Jamie Perkins,2442.41581888464,106.968043607054,17,12,0,5,0,England
Andrzej Kasiewicz,2442.11703220974,119.265801507681,17,13,0,4,0,Poland
Daniel Hostert,2438.50130918098,158.152955923378,6,5,0,1,6,Germany
Olov Winroth,2437.60527375086,118.720389187494,12,8,0,4,0,Sweden
Wolfgang Weber,2436.00493620991,162.912436747923,6,5,0,1,6,Austria
Enno May,2434.83278744036,129.516485551994,11,8,0,3,6,Germany
Bret Fogel,2433.41094479754,159.967823447718,6,5,0,1,0,United.Nations
Kurt Hindman,2432.75365527762,163.305267706945,6,4,0,2,6,USA
Tero Sarkijarvi,2432.08338495142,132.23761396222,10,7,0,3,6,Finland
Alberto Santos,2431.21252500623,123.140458336981,12,9,0,3,0,Portugal
Sietse Sommeling,2430.41611873285,127.14568632402,12,10,0,2,0,Netherlands
Karol Sosnowski,2428.82497379863,104.600200526585,17,12,0,5,0,Poland
Brett Wilkie,2427.43587618068,104.498077620168,17,12,0,5,0,England
Ryan Chiriboga,2424.36336330816,122.723808105723,12,9,0,3,0,USA
Christopher Davies,2424.06974025463,163.383773533236,6,5,0,1,6,NA
Igor Kazmierski,2423.12377774784,172.953144325332,5,4,0,1,12,France
Eliot Kimpton,2422.12248090146,119.440146430794,12,9,0,3,0,England
James Moorhouse,2420.42344709217,122.288137888903,12,8,0,4,0,Australia
Teemu Aro,2417.28218551321,111.195643009509,17,11,0,6,0,Finland
Jeremy Lee,2413.14528745998,116.8170258498,12,7,0,5,0,USA
Gil Surepi,2411.9900019238,133.632584372371,11,9,0,2,0,Denmark
Wolfgang Zurowetz,2409.64880133927,164.373881477935,6,3,0,3,6,Austria
Benjamin Kierkegaard,2409.48715468069,120.921837738223,12,8,0,4,0,Denmark
Mathias LÃ¼tzkendorf,2407.17129575043,117.275288992048,12,8,0,4,0,Germany
Bernhard Fischer,2403.3610943943,117.569112081605,12,8,0,4,0,Germany
Mikko Heinola,2402.22143055658,108.58376663103,17,11,0,6,0,Finland
Wout Maerschalck,2400.28590554546,120.775775417994,12,8,0,4,0,Belgium
Jeff Everitt,2396.51977437094,149.249732055882,6,4,0,2,0,Canada
Marco Elitropi,2389.11175608998,119.741247233995,12,9,0,3,0,Italy
Kamil Nowak,2386.30359777685,148.963091929049,6,4,0,2,6,Poland
Martin Hornacek,2385.44375452774,125.286903530768,11,8,0,3,6,Slovakia
Johan Dyrlind,2381.83552986627,158.385838528877,6,4,0,2,0,Sweden
Guenter Oelfke,2381.49070497459,154.328820927502,6,4,0,2,0,Germany
Craig Conroy,2373.79633140805,124.641139226924,11,7,0,4,6,USA
Pierre Arnauld de Seze,2372.32221907987,156.743173642613,12,9,0,3,6,France
Michal Konieczny,2371.16463217409,127.087103594044,11,6,0,5,6,Poland
Phil Shaw,2369.98174456632,128.530850954857,11,7,0,4,0,England
Jim Gradwell,2369.93245694646,151.665473659463,6,4,0,2,0,England
Kris Raynes,2368.85175264179,166.242922604332,5,3,0,2,12,England
Olli Reunanen,2368.54986554439,129.240662286398,11,8,0,3,6,Finland
Dmitry Khalansky,2368.23625312923,108.01579192356,17,12,0,5,0,Russia
Brynn Holdstock,2368.13687168458,121.606847823072,12,7,0,5,0,Canada
Pauli Lehtoranta,2366.50708639194,162.394577450954,6,3,0,3,0,Finland
Joshua Bates,2364.96499452557,146.588323467226,6,4,0,2,0,Australia
Jaromir Skirmuntt,2364.24528395022,124.063632644023,11,7,0,4,6,Slovakia
Pini Joshua,2361.46077984962,164.68101165146,6,5,0,1,0,Italy
Marc André Leblanc,2356.9504610819,115.656367216535,12,7,0,5,0,Canada
Dorian Gordon,2356.56575663302,173.509754801554,6,5,0,1,0,Spain
Andrew Kenny,2350.1448791202,164.237080379112,6,5,0,1,0,United.Nations
Joakim Rapp,2347.56599608493,106.059197033772,17,10,0,7,0,Sweden
Jake Van Meter,2347.37052909227,105.940847406507,17,10,0,7,0,USA
Christian Aas,2346.54354578392,110.603592612261,17,11,0,6,0,Sweden
Brian Marino,2346.41250091287,147.952367299582,6,4,0,2,0,USA
Mathieu Buttin,2345.27689644993,173.517504688209,5,4,0,1,12,France
Dominik de Cassan,2345.12106407084,153.564781858348,6,4,0,2,0,Germany
Daniel Pawelka,2344.76780808709,126.103527668244,11,7,0,4,6,Austria
Gustav Linderup,2344.28729551409,168.280927158838,5,3,0,2,12,Sweden
Matt Oakley,2344.0506708582,127.149734529987,11,6,0,5,6,England
Andy Garrard,2343.96260843702,200,0,0,0,0,0,England
Andy McBirnie,2343.96260843702,200,0,0,0,0,0,England
Ben diBosdari,2343.96260843702,200,0,0,0,0,0,England
Chris Murdoch,2343.96260843702,200,0,0,0,0,0,England
Jamie Cooke-Rogers,2343.96260843702,200,0,0,0,0,0,England
Nathan Hoole,2343.96260843702,200,0,0,0,0,0,England
Ryan Evans,2343.96260843702,200,0,0,0,0,0,England
Toby Nathan,2343.96260843702,200,0,0,0,0,0,England
Paul North,2343.83051480524,103.177848986288,17,11,0,6,0,England
Brent Simon,2342.76290903719,200,0,0,0,0,0,USA
Chris Green,2342.76290903719,200,0,0,0,0,0,USA
Dan Yount,2342.76290903719,200,0,0,0,0,0,USA
Julien Lesage,2342.76290903719,200,0,0,0,0,0,USA
Michael Ireland,2342.76290903719,200,0,0,0,0,0,USA
Trevor Attridge,2342.76290903719,200,0,0,0,0,0,USA
Trevor Christensen,2342.76290903719,200,0,0,0,0,0,USA
SÃ¸ren Kongsgaard,2342.35761283971,155.354443345557,6,4,0,2,6,Denmark
Leif Barleben,2342.15523799426,176.491914940937,5,4,0,1,12,Germany
Aat Niehot,2339.29400915965,125.776112233854,11,8,0,3,0,Netherlands
Quentin Recours,2336.12236447082,109.254708036101,17,11,0,6,0,France
Danny Modesto,2335.98509555378,163.391864804752,5,3,0,2,12,USA
Denis Korzun,2335.2788055516,105.550387845131,17,10,0,7,0,Sweden
Pawel Blados,2333.53226336851,153.786352417209,6,3,0,3,0,Poland
Andreas Holm,2333.45468075638,110.355935941422,17,11,0,6,0,Sweden
Klaas Luyckx,2329.58177276025,123.763876837257,12,7,0,5,0,Belgium
Moritz Riegler,2329.19357314034,108.621798016785,17,11,0,6,0,Germany
Dustin McWhirter,2328.21846331454,161.589492829172,6,4,0,2,6,Canada
Brandon Cating,2326.95535065379,142.105632445098,6,3,0,3,0,USA
Jakub Irzyk,2324.9594493516,150.107010747986,6,3,0,3,0,Poland
Dimitrios Kasdovasilis,2320.89024354587,158.729866095468,5,3,0,2,6,Greece
John McNeil,2319.85062240519,153.596228090241,6,4,0,2,6,Canada
Janos Sälzer,2318.94245953311,126.257305117216,11,6,0,5,6,Germany
Jason Flanzer,2317.874201721,167.732055444471,5,3,0,2,12,USA
Filip Zingmark,2313.94364318763,200,0,0,0,0,0,Sweden
Fredrik Rabén,2313.94364318763,200,0,0,0,0,0,Sweden
Gustav Berggren,2313.94364318763,200,0,0,0,0,0,Sweden
Niklas Bergmark,2313.94364318763,200,0,0,0,0,0,Sweden
Ola Segerberg,2313.94364318763,200,0,0,0,0,0,Sweden
Mike Puryear,2313.86804700016,122.427361621237,11,6,0,5,0,USA
Jakub Grzegorzek,2312.21879355548,126.880778883283,11,8,0,3,0,Norway
Billy Robin,2311.65134622491,167.542506983621,5,3,0,2,12,USA
Weran,2310.18404960496,174.890901079759,6,4,0,2,6,Latvia
Andrea Cesana,2309.34199323032,142.929054933227,6,4,0,2,0,Italy
Jeff Traish,2308.78227480287,163.878496933753,6,4,0,2,6,Australia
Alasdair Johnstone,2308.66670309455,106.669603707117,17,10,0,7,0,Scotland
Erich Hochauer,2303.01523386724,127.267003742542,11,7,0,4,6,Austria
Emiliano Traversi,2302.23868831348,109.873316103243,17,8,0,9,0,Italy
Conor Burnell,2302.17082255662,123.797835832179,12,6,0,6,0,Ireland
Dyland Simmer,2300.27849752713,117.21801311568,12,6,0,6,0,United.Nations
Edoardo Rinaldi,2300.10255399041,150.039322857057,6,4,0,2,0,Italy
Stefan Mader,2294.65088692057,169.40448058219,5,3,0,2,12,Austria
Chandler Davidson,2294.47251272401,118.501027263231,12,7,0,5,0,Canada
Tatu Purhonen,2292.97455950012,105.411306055795,17,10,0,7,0,Finland
Gerry Hodgson,2290.88805043763,151.561010997465,6,4,0,2,6,Canada
Torbjorn Hansson,2290.0968194925,117.876050634948,12,7,0,5,0,Sweden
Adrian Weygandt,2288.22123137675,125.914209916201,11,6,0,5,6,Austria
Jeppa Resmark,2288.14464772302,121.950114340538,11,6,0,5,6,Sweden
Michael Dick,2287.32418270835,105.424816129468,17,9,0,8,0,Scotland
Novikov Bogdan,2286.85505615556,153.435383480059,6,4,0,2,6,Russia
Laurens Tanguy,2286.27483807931,104.644587394969,17,10,0,7,0,Belgium
Novikov Mikhail,2285.93160795229,168.543442297525,6,4,0,2,6,Russia
Rickard Nilsson,2285.70910103557,110.432458214165,17,8,0,9,0,Sweden
Konrad KrÃ³licki,2284.23297824344,146.618887223982,6,4,0,2,0,Poland
Michael Ilegems,2281.76430584866,167.552168724056,5,3,0,2,12,NA
Adam Szugajew,2279.73377507233,200,0,0,0,0,0,Poland
Adam Szymanski,2279.73377507233,200,0,0,0,0,0,Poland
Andrzej Reszelski,2279.73377507233,200,0,0,0,0,0,Poland
Mateusz Dziewanowski,2279.73377507233,200,0,0,0,0,0,Poland
Mateusz Szulc,2279.73377507233,200,0,0,0,0,0,Poland
Piotr Gotowiec,2279.73377507233,200,0,0,0,0,0,Poland
Rafal Anusiak,2279.73377507233,200,0,0,0,0,0,Poland
Wiktor Harezlak,2279.73377507233,200,0,0,0,0,0,Poland
Stefan Riegler,2279.11224071725,122.882337962633,11,6,0,5,6,Austria
Christian Vestol,2277.38214379188,111.797424172444,17,11,0,6,0,Norway
Benjamin Ade Thurow,2276.29353552471,170.426699650657,5,2,0,3,12,NA
Philip Johnston,2275.54897754261,119.547008909885,12,7,0,5,0,Ireland
Stefan Benediktsson,2273.11853254333,119.189029523486,12,6,0,6,0,Sweden
Artur Rietz,2272.98497031567,133.645317762665,11,7,0,4,6,Poland
Tadeusz Czerwinski,2268.13797502915,169.846358787762,5,3,0,2,12,Poland
Martin Huf,2264.12533817937,106.63941098043,17,9,0,8,0,Germany
Alfredo Virgillito,2263.61363053172,200,0,0,0,0,0,Germany
Christopher Muller,2263.61363053172,200,0,0,0,0,0,Germany
Dominik de Cassan: Axis+Iron Mother,2263.61363053172,200,0,0,0,0,0,Germany
Florian Platte,2263.61363053172,200,0,0,0,0,0,Germany
Hinnerk Fischer,2263.61363053172,200,0,0,0,0,0,Germany
Moritz Gatt,2263.61363053172,200,0,0,0,0,0,Germany
Jeff Galea,2260.8103210854,121.850545249869,12,5,0,7,0,Australia
Josh Blakemore,2257.86681818029,147.955742601438,6,3,0,3,0,Middle.East
Tyler Webb,2257.37513794813,120.981830886809,12,7,0,5,0,Canada
Liam Jordan,2256.08166286207,176.388606830955,5,3,0,2,12,England
Cory Doyle,2256.0445013705,200,0,0,0,0,0,Canada
Josh Richter,2256.0445013705,200,0,0,0,0,0,Canada
Tim Fung,2256.0445013705,200,0,0,0,0,0,Canada
Gord Weppler,2254.4181677756,113.278933165689,12,6,0,6,0,Canada
Christian Metz,2253.89118522628,105.414054345539,17,9,0,8,0,Germany
Rob Kneepkens,2253.39987952378,152.377652634483,6,4,0,2,6,Netherlands
Raul Segado,2252.75209954489,155.912558812424,6,4,0,2,0,Spain
Mike O'Brien,2249.57434016486,122.463595819604,12,7,0,5,0,Northern.Ireland
Alexander Grob,2247.31150930017,126.659180917519,11,7,0,4,6,Austria
Tommy Geuns,2247.22897193827,108.123542815752,17,8,0,9,0,Belgium
Daniel Maierl,2246.19859768162,0,0,0,0,0,0,Austria
Laszlo Vuray,2246.19859768162,0,0,0,0,0,0,Austria
Martin Florian,2246.19859768162,0,0,0,0,0,0,Austria
DCM,2246.19859768162,200,0,0,0,0,0,Austria
JustDan,2246.19859768162,200,0,0,0,0,0,Austria
Mr.Wu,2246.19859768162,200,0,0,0,0,0,Austria
Raghnath,2246.19859768162,200,0,0,0,0,0,Austria
Snot,2246.19859768162,200,0,0,0,0,0,Austria
Lukasz Kruszenski,2244.8917974824,120.287853014532,12,6,0,6,0,Canada
Alexandre Maiffret,2243.70372136066,115.6229205181,12,6,0,6,0,France
Peter Rodler,2243.37054648371,120.913590031874,12,6,0,6,0,Denmark
Ferenc Venczel,2242.26326087003,154.411138293778,6,4,0,2,6,Hungary
Marc Nielsen,2241.50764342328,165.824304006436,6,3,0,3,0,Denmark
Bernhard Bornatowicz,2239.89209850983,127.845720111223,11,6,0,5,6,Austria
Kai Soltau,2238.91634102856,172.532516530709,5,3,0,2,12,Austria
SÃ¸ren Husum,2238.64502715013,150.488155876543,6,4,0,2,6,Denmark
Chris Gatt,2238.58382344325,161.07940163868,6,4,0,2,6,Malta
Ben Fuzi,2238.42732033213,149.785281237039,6,3,0,3,0,Germany
AurÃ©lien Guiramand,2236.66553755748,119.770125479161,12,6,0,6,0,France
Diego Moruzzo,2235.5042042819,120.126186898504,12,6,0,6,0,Italy
Kerazoglou Nikolaos,2233.77579045451,156.248254707926,6,3,0,3,0,Greece
Peter Cornelious DyhreÂ­Poulsen,2232.2801501949,150.760267861163,6,3,0,3,0,Denmark
Konstantin Kruchinin,2231.36029318649,157.262197541959,6,3,0,3,0,Russia
Sebastian Kaas Petersen,2230.87032534467,152.754713136969,6,3,0,3,0,Denmark
Darren,2230.57558813524,154.86876738062,6,3,0,3,6,Malta
Janne Mikkola,2228.26976862328,122.360015806687,12,6,0,6,0,Finland
Frederik Punt,2227.18046242963,160.730645931017,6,3,0,3,0,Netherlands
Mike Davies,2225.95718933098,121.202786687142,11,6,0,5,0,Wales
Laurents Rønved,2222.97630629109,122.129144282204,11,5,0,6,6,Denmark
Luis Leite,2221.20434136326,153.951639610456,6,3,0,3,0,Portugal
Orestis Argiropoulos,2220.90138721604,121.753364789683,12,8,0,4,0,Greece
Samu Jarvinen,2220.89259948401,119.668186431912,12,6,0,6,0,Finland
Viktor Nelipovich,2218.70034890232,107.703619619665,17,9,0,8,0,Russia
Ivanov Andrei,2216.42930281587,152.050672628351,6,3,0,3,6,Russia
Andrei Ivanov,2216.30074220075,123.42295232282,11,6,0,5,0,Russia
Anthony O'Reilly,2215.94987934041,125.87595247037,10,5,0,5,0,Ireland
Dylan Sultana,2215.5436673221,159.554471195037,6,2,0,4,6,Malta
Adrien Cahier,2214.56633930015,149.467295964436,6,3,0,3,0,France
Antti Jussila,2213.20803082987,200,0,0,0,0,0,Finland
Iiro Järvenpää,2213.20803082987,200,0,0,0,0,0,Finland
Jani Kautto,2213.20803082987,200,0,0,0,0,0,Finland
Jarkko Vahamaa,2213.20803082987,200,0,0,0,0,0,Finland
Joonas Heinonen,2213.20803082987,200,0,0,0,0,0,Finland
Tuomas Toimela,2213.20803082987,200,0,0,0,0,0,Finland
Mikkel Christensen,2212.04552257221,115.428485917342,12,7,0,5,0,Norway
Julien Rieant,2211.8457749416,147.786341135879,6,3,0,3,0,France
SÃ¸ren Laust Jacobsen,2211.0977193389,148.161622599312,6,2,0,4,0,Denmark
Vojtech Medonos,2207.25255184155,124.188422547984,12,8,0,4,0,Czech.Republic
Gabor Wolf,2206.34212681497,132.723988719608,11,7,0,4,6,Hungary
Nikolaos Kerazoglou,2204.59671368229,148.810649369269,6,3,0,3,6,Greece
Andre Suwanda,2204.32848107016,156.680865797614,6,3,0,3,6,Switzerland
Michal Nakonieczny,2202.22095063152,106.88926728097,17,7,0,10,0,Poland
Florian Hartmann,2200.489569112,135.732760157679,10,5,0,5,7,Austria
Davide Insinna,2199.73259091853,200,0,0,0,0,0,Italy
Francesco Recchiuti,2199.73259091853,200,0,0,0,0,0,Italy
Vincenzo Rotondo,2199.73259091853,200,0,0,0,0,0,Italy
Daniel Knauss,2198.05433120208,128.094564118068,11,6,0,5,6,Germany
Ntemiris Panagiotis,2198.0322862345,161.272266643909,6,3,0,3,0,Greece
Simon Sorensen,2196.14544204894,121.296635497207,11,5,0,6,6,Denmark
Niek van Slagmaat,2195.67985506211,155.57380376162,6,4,0,2,6,Netherlands
Peter Gaublomme,2195.18741419306,117.203459348635,12,6,0,6,0,Belgium
Chris Orr,2193.97635179554,152.246459006347,6,2,0,4,0,Canada
Chad Shonkwiler,2191.65824004679,176.047053433407,5,2,0,3,12,USA
Ross Harkin,2189.06926232289,146.890647988837,6,3,0,3,0,Scotland
Stuart Gorman,2188.1397046326,121.984122746355,11,5,0,6,6,Ireland
Phil Doogan,2187.51892983497,157.334094370615,6,3,0,3,0,Ireland
Philipp Schaper,2187.14698092792,152.714361143983,6,3,0,3,0,Germany
Julien Dupoirieux,2185.8656480218,123.559193484648,12,5,0,7,0,France
Eoin Brennan,2184.75680092924,103.902468886682,17,8,0,9,0,Ireland
Casper Jellema,2182.63566629268,105.677476094317,17,9,0,8,0,Netherlands
Emil,2181.67521849973,172.999264412762,5,2,0,3,12,Denmark
Frederik Munch,2181.67521849973,200,0,0,0,0,0,Denmark
Nikolaj Ulf,2181.67521849973,200,0,0,0,0,0,Denmark
Søren,2181.67521849973,200,0,0,0,0,0,Denmark
Niels Pecherz,2180.8106393852,153.523158649242,6,3,0,3,6,Germany
Kuba,2180.76520589968,153.981060864682,6,3,0,3,6,Norway
Michael Marlier,2176.76034933054,170.97707290882,5,3,0,2,12,NA
Panagiotis Ntemiris,2175.63968334953,154.391412483077,6,3,0,3,6,Greece
Paris Boubouras,2175.03899003737,157.553773225796,6,4,0,2,0,Greece
Wojciech Guzowski,2174.87452397282,180.162845760079,5,2,0,3,12,Poland
Kevin Maeder,2174.23179234139,121.808262022371,12,5,0,7,0,Portugal
Yaroslav Karmannyy,2173.40915571635,152.660513546008,6,3,0,3,0,Russia
Mark Attard,2173.00008349712,147.637380028399,6,3,0,3,6,Malta
Baptiste Schmittlin,2171.82601382393,108.539237702104,17,8,0,9,0,France
Bogdan Novikov,2170.72900787885,152.238638785018,6,3,0,3,0,Russia
Russell Harman,2170.49368315109,152.064158033093,6,3,0,3,0,United.Nations
Stephan Germark,2165.89258923976,126.772138260259,11,5,0,6,0,Denmark
Matej TkÃ¡c,2163.01119828861,155.478905247819,6,2,0,4,6,Slovakia
Szymon Ratka,2162.21698873812,166.666481407783,5,2,0,3,12,Poland
Peter Croft,2161.92158170792,121.900547409773,12,4,0,8,0,Ireland
Dirk Pintjens,2161.68913319579,113.893901803662,17,7,0,10,0,Belgium
David Horwitz,2161.37051566119,125.862147891611,10,5,0,5,6,Austria
Thomas Kastmann,2160.45453850153,123.974494941026,12,7,0,5,0,Norway
Adam Jones,2159.86346604333,146.639581199537,6,3,0,3,0,Wales
Fernando Segado,2159.77055073778,162.565314816517,6,3,0,3,0,Spain
Areinikus,2159.51724008606,163.361675984446,6,4,0,2,6,Latvia
PÃ©ter MolnÃ¡r,2159.40971155157,126.544232574365,11,6,0,5,6,Hungary
Jaden Liu,2159.14600290644,160.894376671471,6,3,0,3,6,China
Pietro Fauch,2156.01173014107,105.23203560046,17,8,0,9,0,Italy
Miguel Correia,2151.89444132802,109.678624936392,17,7,0,10,0,Portugal
Christophe Dirckx,2147.59721047475,161.344967647105,6,3,0,3,6,Belgium
Jonas Brand,2147.55435531647,108.788409433139,16,8,0,8,0,Norway
Kasdovassilis Dimitrios,2147.41458791088,157.515248215237,6,3,0,3,0,Greece
David Hendrikx,2147.2114057261,153.780643522914,6,3,0,3,6,Netherlands
Mark Hayes,2146.95965051861,200,0,0,0,0,0,Ireland
Michael Porter,2146.95965051861,200,0,0,0,0,0,Ireland
Patrick Long,2146.95965051861,200,0,0,0,0,0,Ireland
Rob Read,2146.95965051861,200,0,0,0,0,0,Ireland
Tom Starren,2145.36036375032,110.858052711565,17,7,0,10,0,Netherlands
Pat Vance,2144.77683150707,124.208519573088,11,5,0,6,0,England
Niko Ranta,2144.04691294264,157.752006891032,6,2,0,4,0,Finland
Sami Suikki,2143.29564556066,108.672861652723,17,8,0,9,0,Finland
Antoine Granet Tza,2140.70809304416,200,0,0,0,0,0,France
Matthieu Vega Mouskapet,2140.70809304416,200,0,0,0,0,0,France
Victor Pons Tec,2140.70809304416,200,0,0,0,0,0,France
Sankha Amarakoon,2138.35844753943,150.86627143534,6,2,0,4,6,Netherlands
David Smith,2137.82533144765,166.810026040137,6,3,0,3,6,United.Nations
Botond Gati,2137.12156128966,169.411733827664,5,2,0,3,12,Switzerland
Dominic Beyeler,2131.80329902801,106.696969931794,17,9,0,8,0,Switzerland
Soren,2131.3146422159,168.990785919215,5,2,0,3,12,Denmark
Joao Nunes,2130.66167024941,127.13572698255,11,5,0,6,0,Portugal
Artem Volik,2129.6122994026,106.285333740614,17,7,0,10,0,Russia
Jun Chan,2129.15824046344,150.722661038298,6,3,0,3,0,Netherlands
Jason Jenson,2128.67284573168,120.257759470022,12,5,0,7,0,Ireland
Marc Heredia,2127.59950816858,152.313613995198,6,3,0,3,0,Spain
BenoÃ®t CÃ©rÃ©,2127.37184128141,169.537633109642,5,2,0,3,12,France
Carlo Piccinini,2126.6067547682,126.808720599011,11,5,0,6,6,Italy
Alexandra Martinez,2126.52839195855,156.676099983959,6,2,0,4,0,Spain
Matthew,2126.21569742951,153.8253092089,6,3,0,3,6,Malta
Torjus EftestÃ¸l,2125.12252622663,155.446110121641,6,2,0,4,6,Norway
George Banavos,2124.80667808934,117.139643857083,12,6,0,6,0,Greece
Eetu Jokinen,2124.75839270258,163.972723768186,6,2,0,4,6,United.Nations
Alexander Alig,2124.50787419895,150.862510821869,6,3,0,3,6,Switzerland
Rudolf Edlmayer,2120.27705733113,137.76948428957,10,5,0,5,6,Hungary
David Kane,2119.42240964028,124.007978385416,11,5,0,6,0,Scotland
Ross Silvers,2119.14764379188,141.114948636888,11,3,0,8,0,Scotland
Valérian Tschanz,2119.08087562829,125.147274246818,11,5,0,6,6,France
David Mace,2118.54580767114,200,0,0,0,0,0,Scotland
Nicholas Joyce,2118.54580767114,200,0,0,0,0,0,Scotland
Martin Šcepán,2118.10480796207,126.129894765458,11,4,0,7,6,Slovakia
Charles Soong,2115.65230994603,157.931410915502,6,1,0,5,0,Canada
Dimitrios Bozikas,2115.23199254838,149.753191597115,6,2,0,4,6,Greece
Ian Campbell,2115.13540298696,153.339865238083,6,2,0,4,0,Scotland
Joao Isidro,2114.89027178716,121.609695558238,12,5,0,7,0,Portugal
Gard Andresen,2114.11692234371,126.005514900847,11,4,0,7,6,Norway
Christoph Van Der Schoot,2114.11356742588,160.29363056836,6,3,0,3,0,Belgium
Norman Spiteri,2113.15827969099,150.042009314744,6,2,0,4,6,Malta
Dominic Leedham,2112.50255006419,152.463544606351,6,2,0,4,0,United.Nations
Stephen Schembri,2112.2862001407,155.333601623294,6,3,0,3,6,Malta
Dave den Ouden,2111.02866143883,200,0,0,0,0,0,Netherlands
Maarten Koopmans,2111.02866143883,200,0,0,0,0,0,Netherlands
Marc de Ruiter,2111.02866143883,200,0,0,0,0,0,Netherlands
Michael Boom,2111.02866143883,200,0,0,0,0,0,Netherlands
Michiel Smits,2111.02866143883,200,0,0,0,0,0,Netherlands
Paul de Geus,2111.02866143883,200,0,0,0,0,0,Netherlands
Vincent van der Bijl,2111.02866143883,200,0,0,0,0,0,Netherlands
William Bekkema,2111.02866143883,200,0,0,0,0,0,Netherlands
Gergely Gati,2110.48925747767,126.582394243007,11,4,0,7,6,Switzerland
Peter Bom Jensen,2109.67103258048,101.886576637612,17,7,0,10,0,Denmark
Frazer Penman,2108.96614224516,176.545625882975,6,1,0,5,0,Scotland
Andrew Marzec,2107.89763939372,146.24687945384,6,3,0,3,0,China
Richard McHale,2107.20109718438,170.654495580897,5,2,0,3,12,Scotland
Anjo Brand,2104.98546843063,118.942976967911,12,5,0,7,0,Netherlands
Endre Fodstad,2103.99688324933,107.490122096954,17,7,0,10,0,Norway
Richard McCammon,2103.78296606998,146.657942573725,6,2,0,4,0,Middle.East
Henrik Ekholm,2098.51652355783,109.952252745844,17,7,0,10,0,Switzerland
Kirill Ustilovskiy,2094.03383346404,0,0,0,0,0,0,Russia
MÃ¡tÃ© TÃºri,2093.573890824,155.77143411707,6,3,0,3,6,Hungary
Tim Bossuyt,2091.81476193383,125.661414496572,11,4,0,7,6,Belgium
Tudor Stanescu,2089.5805724578,155.78004843066,6,3,0,3,6,Switzerland
Dan Porter,2089.28958739572,155.904534695931,6,2,0,4,0,Ireland
Byron Liles,2088.41367892039,147.371467897384,6,2,0,4,0,Wales
Aaron Boyhan,2086.90689531382,165.012131179619,5,2,0,3,12,Wales
Kailam Dale,2084.65809143925,166.263842020717,5,2,0,3,12,Wales
Matt Townsend,2084.4688301361,155.247666960161,6,2,0,4,6,England
AndrÃ¡s PorkolÃ¡b,2084.40957226691,150.434643324049,6,3,0,3,6,Hungary
Vasco Oliveira,2083.83474112116,120.208323081129,12,4,0,8,0,Portugal
Orelkin Evgeny,2082.17434481785,161.79160403908,6,2,0,4,6,Russia
Harry Cullen,2080.07905584762,119.381500505715,12,4,0,8,0,Ireland
Terje Boye,2078.43122795767,104.360782247504,17,6,0,11,0,Norway
Asbjorn Willarsrud,2078.40092349531,200,0,0,0,0,0,Norway
Jarle Svendsrud,2078.40092349531,200,0,0,0,0,0,Norway
Martin Andre Rohme,2078.40092349531,200,0,0,0,0,0,Norway
Mats Aubell,2078.40092349531,200,0,0,0,0,0,Norway
Jason Enos,2078.14218751747,191.772414446544,4,1,0,3,13,England
John Henneli,2078.12818333407,131.270543555715,11,4,0,7,0,Norway
Milo Fuggin,2075.36583301869,166.139648023408,5,2,0,3,12,Italy
Luke Mason,2074.92993973285,124.612496179706,12,3,0,9,0,Scotland
Antoine Bilocca,2073.13180593221,156.922659189737,6,2,0,4,6,Malta
Jay Mcleod,2073.10619569756,147.746969134826,6,3,0,3,0,China
Marc Morgan,2070.84486024799,170.067668605426,6,2,0,4,0,Wales
Damiano Pennini,2070.74799419279,122.149212726247,12,3,0,9,0,Italy
Evgenii Mikhailovskii,2068.59685935172,124.10586070929,12,4,0,8,0,Russia
Ed Smith,2067.72749208744,160.740055399064,6,2,0,4,6,England
Henry  Lehmann,2065.46066707282,178.410914972499,5,1,0,4,12,Germany
Enrique Lopez,2063.29182340151,145.838048945427,6,2,0,4,0,Spain
Hermanni Raatevaara,2061.79807751542,125.486501989577,11,3,0,8,0,Finland
Damien Ribeiro,2061.11638387757,158.906800759851,6,2,0,4,6,France
Ciaran Bolger,2059.82658220958,124.583534556927,11,4,0,7,6,Ireland
Franck Primavera,2056.80906534044,163.494594912578,5,2,0,3,12,NA
Liang Yan,2054.90912949529,167.744144174894,6,3,0,3,6,China
Harm Kleijnen,2054.64638826616,106.601379598591,17,6,0,11,0,Netherlands
Joao Morais,2053.96097073538,108.339618886786,17,6,0,11,0,Portugal
Soren Lister,2052.77581642569,155.268219925879,6,2,0,4,0,Denmark
Eduard Berdjugin,2050.18914764595,149.047157457327,6,3,0,3,6,Latvia
Tomas Mennes,2048.49384533108,119.57831737302,12,5,0,7,0,Belgium
Paul Bridge,2047.10267182395,167.700504572411,5,1,0,4,12,Denmark
Csaba Mile,2046.07318190612,200,0,0,0,0,0,Hungary
Kozhushko Olexii,2043.56801576473,157.041610188257,6,2,0,4,6,Ukraine
Ian Alderdice,2043.38213129466,117.311083489922,12,4,0,8,0,Northern.Ireland
Doug Fazzani,2042.57417843335,175.081222169264,5,1,0,4,12,Wales
Marnix Baas,2042.23382572454,150.924108323085,6,2,0,4,0,Netherlands
Alun Evans,2039.36315641162,200,0,0,0,0,0,Wales
Ben Jenkins,2039.36315641162,200,0,0,0,0,0,Wales
Pete Hillard,2039.36315641162,200,0,0,0,0,0,Wales
Sam Derbyshire,2039.36315641162,200,0,0,0,0,0,Wales
Scott Hooper-Jones,2039.36315641162,200,0,0,0,0,0,Wales
JÃ¡nos Kendi,2039.30793654833,161.590337493279,5,2,0,3,6,Hungary
Gorbachyk Oleksii,2033.4068971491,164.487788466405,6,3,0,3,6,Ukraine
RJ Marchant,2028.96636714996,148.85126033995,6,2,0,4,6,Canada
Bozikas Dimitrios,2025.48085918297,158.468005686208,6,1,0,5,0,Greece
Martin Polák,2025.37810031719,103.723904263988,17,5,0,12,0,Slovakia
Eric Liu,2024.04749813755,147.114595907023,6,2,0,4,0,Middle.East
Panagiotis Psonis,2023.62833487,153.507026453573,6,3,0,3,6,Greece
Andreas Rizopoulos,2022.81829878189,200,0,0,0,0,0,Greece
Dimitris Kasdiovasilis,2022.81829878189,200,0,0,0,0,0,Greece
Giannis Agoras,2022.81829878189,200,0,0,0,0,0,Greece
Konstantinos Oikonomopoulos,2022.81829878189,200,0,0,0,0,0,Greece
Marios Oikonomopoulos,2022.81829878189,200,0,0,0,0,0,Greece
Nikos Kerazoglou,2022.81829878189,200,0,0,0,0,0,Greece
Panagiotis Demiris,2022.81829878189,200,0,0,0,0,0,Greece
Spyros Karakitsos,2022.81829878189,200,0,0,0,0,0,Greece
Mikko Kulmala,2022.25692906623,165.284421896539,5,1,0,4,12,Finland
Paul Letherby,2021.16736495511,151.542742346784,6,2,0,4,0,Wales
Mikhail Novikov,2020.43724893388,172.33093125731,6,3,0,3,0,Russia
Alexis Celnik,2019.85745186811,163.261407523486,6,2,0,4,0,Wales
Niels De Vlieger,2015.06449200828,200,0,0,0,0,0,Belgium
Steven De Canck,2015.06449200828,200,0,0,0,0,0,Belgium
Daniel Bogdanoski,2011.42683861439,120.244469847755,12,4,0,8,0,Czech.Republic
Rhys Phillips,2008.36125246131,149.258684551351,6,1,0,5,0,Wales
Gerry Nolan,2007.96198619171,126.57942935332,11,4,0,7,6,Ireland
Petr Cermak,2007.67156901102,164.482251268314,6,3,0,3,6,Czech.Republic
Spyros Pavlis,2007.42761310779,149.362378686211,6,2,0,4,6,Greece
Adrian Ramos,2007.02519436976,200,0,0,0,0,0,Spain
Javier Sanchez,2007.02519436976,200,0,0,0,0,0,Spain
Jorge Cerdá,2007.02519436976,200,0,0,0,0,0,Spain
Josep Raúl López,2007.02519436976,200,0,0,0,0,0,Spain
Manuel Tulla,2007.02519436976,200,0,0,0,0,0,Spain
Fraser Phillips,2006.22164680513,0,0,0,0,0,0,Middle.East
Andy Powell,2006.22164680513,200,0,0,0,0,0,Middle.East
Bryce Geeraert,2006.22164680513,200,0,0,0,0,0,Middle.East
HÃ¥vard Kongsrud,2004.29716629794,173.574268365292,5,1,0,4,12,Norway
Gert Vos,2003.92137423402,150.265678011917,6,2,0,4,0,Belgium
Krzysztof Pyra,2000.49477953289,173.522218954817,6,1,0,5,6,Poland
Alexander Loginov,1998.93156533658,117.868649530679,12,4,0,8,0,Russia
Christoph Schrage,1997.09578924651,150.781927840869,6,1,0,5,0,Spain
Nicolas Smit,1996.90281633996,170.688975556829,5,1,0,4,12,Belgium
Andre Valentim,1995.79203471711,200,0,0,0,0,0,Portugal
Bruno Settimelli,1995.79203471711,200,0,0,0,0,0,Portugal
Salvador Caetano,1995.79203471711,200,0,0,0,0,0,Portugal
Alexis Vallalta,1995.79203471711,0,0,0,0,0,0,Portugal
Maksimiljan Galos,1995.1175265464,151.578594644603,6,2,0,4,6,Ukraine
Aubrey Linen,1994.33774591684,155.938170506169,6,2,0,4,0,Middle.East
PÃ¤r-Ola Nilsson,1994.16700946052,170.245244220929,5,1,0,4,12,Sweden
Robert Willemstein,1993.89591077917,173.996622298333,5,1,0,4,12,Netherlands
Georg Buscha,1993.54234481983,155.141584554511,6,1,0,5,0,Netherlands
Martyn Jenkins,1992.5727173176,133.729383016847,11,2,0,9,0,Wales
Simon Henry,1991.74163199373,176.460204454027,5,2,0,3,12,France
Teppo Aro,1987.26771612105,139.535331341974,10,3,0,7,7,Finland
Zoltan Gaal,1985.65181248434,150.033583242303,6,2,0,4,6,Hungary
Moritz Schwank,1984.23928466022,139.186333829613,11,2,0,9,6,Switzerland
Nuno Sequeira,1981.24980071254,134.065975898405,11,3,0,8,6,Portugal
John Foster,1980.89881935401,118.221132920079,12,4,0,8,0,Northern.Ireland
Aleksandr Blumental,1977.85288422863,200,0,0,0,0,0,Latvia
Andrei Isaev,1977.85288422863,200,0,0,0,0,0,Latvia
Sergei Lakissov,1977.85288422863,200,0,0,0,0,0,Latvia
Giaccomo Mader,1976.91711475601,200,0,0,0,0,0,Switzerland
Lorenz Gredig,1976.91711475601,200,0,0,0,0,0,Switzerland
Marc Trautmann,1976.91711475601,200,0,0,0,0,0,Switzerland
Marco Bernasconi,1976.91711475601,200,0,0,0,0,0,Switzerland
Pascal Kruttli,1976.91711475601,200,0,0,0,0,0,Switzerland
Joseph Hanna,1976.45788166111,172.441328479411,6,1,0,5,0,Middle.East
Lorand Sovenyhazi,1974.82656521512,128.538268436677,11,3,0,8,6,Hungary
LuboÅ¡ Hribik,1973.10854365138,154.316326989072,6,2,0,4,0,Czech.Republic
Nima Yaghmai,1968.55574691251,135.87336108015,11,2,0,9,6,Norway
Joan Butier,1968.29070300917,155.684974752429,6,2,0,4,0,Spain
Marc Simoni,1967.78984128409,109.951194750765,17,4,0,13,0,France
(C) Daniel Bogdanoski,1963.65192787773,200,0,0,0,0,0,Czech.Republic
Adam Tuma,1963.65192787773,200,0,0,0,0,0,Czech.Republic
Jiri Kares,1963.65192787773,200,0,0,0,0,0,Czech.Republic
Lukáš Maršík,1963.65192787773,200,0,0,0,0,0,Czech.Republic
Michal Dzurenda,1963.65192787773,200,0,0,0,0,0,Czech.Republic
Štepán Slavík,1963.65192787773,200,0,0,0,0,0,Czech.Republic
Tomáš Pešták,1963.65192787773,200,0,0,0,0,0,Czech.Republic
Tomas Sedlon,1963.65192787773,200,0,0,0,0,0,Czech.Republic
Stepan Slavik,1963.65192787773,0,0,0,0,0,0,Czech.Republic
Golitsyn Oleksandr,1956.64811301842,152.912452946714,6,2,0,4,6,Ukraine
Federico Ingrosso,1955.3187581174,137.142661829024,11,2,0,9,6,Italy
Cornelius,1950.19449312577,172.381535955189,5,1,0,4,12,Denmark
Chris Wright,1945.04844076936,158.016517956231,6,1,0,5,0,Northern.Ireland
Anthony Ferraiolo,1944.79117146775,183.829039628429,6,0,0,6,6,USA
Spyros Mygdanis,1944.76913322853,154.099830842731,6,1,0,5,0,Greece
Evgeny Orelkin,1939.08008646829,166.58398293494,5,1,0,4,12,Russia
Thomas Fuchs,1935.42481863212,162.868813397299,6,1,0,5,6,Switzerland
Vladimir Kokolia,1935.2820805568,150.916392036059,6,1,0,5,6,Czech.Republic
Ran Tao,1934.7340049507,153.805248289183,6,1,0,5,6,China
Freek Punt,1931.46402596539,162.357393938337,6,1,0,5,6,Netherlands
Andrew Galea,1931.34100586705,160.523385423644,6,1,0,5,6,Malta
Dmitri Pechonkin,1929.62870861708,157.169067214217,6,1,0,5,6,Latvia
Dominique Majoie,1929.29298103047,170.821328786542,5,1,0,4,12,Belgium
Leif Bohli,1925.08601634104,131.361791667863,11,2,0,9,0,Norway
Tomek Dobros,1923.94358138505,152.074318123413,6,1,0,5,0,Northern.Ireland
Eoin Dornan,1914.37241703565,154.626478691032,6,1,0,5,6,Northern.Ireland
Alexandre Barbier,1911.4680307028,167.16071085446,5,1,0,4,12,Belgium
He Jiang,1911.35851366185,152.271828206478,6,1,0,5,0,China
Chen Ge,1909.53655415535,200,0,0,0,0,0,China
Gua,1909.53655415535,200,0,0,0,0,0,China
Guanbo Liu,1909.53655415535,200,0,0,0,0,0,China
Jason Mcleod,1909.53655415535,200,0,0,0,0,0,China
Lei,1909.53655415535,200,0,0,0,0,0,China
Wei Jin,1909.53655415535,200,0,0,0,0,0,China
Yang Song,1909.53655415535,200,0,0,0,0,0,China
Youwei Wu,1909.53655415535,200,0,0,0,0,0,China
Guangjie Wu,1909.2150318895,154.999266961355,6,1,0,5,6,China
Alan Buckley,1909.03607077349,154.2462303292,6,0,0,6,0,United.Nations
Andy Beattie,1905.02715412441,200,0,0,0,0,0,Northern.Ireland
Jonathon Graham,1905.02715412441,200,0,0,0,0,0,Northern.Ireland
Carlos Mendes,1904.5445531217,156.059203596474,6,1,0,5,0,Portugal
Mat McGinn,1903.37799008125,149.675367952876,6,1,0,5,0,Northern.Ireland
Wojciech Kat,1898.90756364867,175.301833973145,6,0,0,6,6,United.Nations
Luke Pollard,1894.59989246824,154.562286084511,6,1,0,5,0,China
Gerard O'Brien,1889.67133581064,158.024525366828,6,1,0,5,0,Northern.Ireland
Espen Dahl,1889.18705460389,148.956661324788,6,1,0,5,0,Norway
Qian Li,1888.07073551054,154.756919401631,6,1,0,5,6,China
Luis Ventura,1882.87458577129,123.951004548723,12,1,0,11,0,Portugal
Panagiotis Stathis,1882.56562899832,169.972465243157,6,0,0,6,6,Greece
Lukas Walliser,1872.1945787102,158.095639263379,6,0,0,6,0,Switzerland
Bastien Gradon,1871.57478956242,157.705931104404,6,1,0,5,6,France
Stathis Panagiotis,1845.64368724401,180.708254631868,6,0,0,6,0,Greece
Adam Fox,1845.08797780551,118.630697655418,12,2,0,10,0,Northern.Ireland
Robi Deola,1837.44310939944,121.183358840265,12,2,0,10,0,Switzerland
Maurus Markwalder,1835.91535821677,133.761820414485,12,1,0,11,0,Switzerland
Magnus Aagaard-Nielsen,1834.94118558546,168.203719231815,6,0,0,6,6,Denmark
Romeu Silva,1833.84790484157,134.003543529475,12,1,0,11,0,Portugal
Christophe Smit,1832.47112761664,135.057789358933,11,1,0,10,6,Belgium
Sergi del Molino,1822.17040774784,163.971220299853,6,0,0,6,0,Spain
Ã‰ric Grux,1820.87852602719,170.776038916261,5,0,0,5,12,France
Ian Bonaci,1812.98354003015,153.225112287039,6,0,0,6,6,Malta
Dmitrii Maliuev,1805.89440844798,164.447861381491,6,0,0,6,6,Russia
Packer,1802.00010096276,154.389113083034,6,1,0,5,6,Latvia
Agis Theodoropoulos,1801.54744713766,167.504637023113,6,0,0,6,6,Greece
Aleksei Guk,1800,200,0,0,0,0,0,Russian
Brin Blatnik,1800,200,0,0,0,0,0,Slovenia
Dmitrii Tochenov,1800,200,0,0,0,0,0,Russian
Enrique Sanchez,1800,200,0,0,0,0,0,UAE
Jan Kleva Ivancic,1800,200,0,0,0,0,0,Slovenia
Jean-Sebastien Imbeau,1800,200,0,0,0,0,0,Slovenia
John Helz,1800,200,0,0,0,0,0,UAE
Mike Dunlop,1800,200,0,0,0,0,0,UAE
Nathan Bosa,1800,200,0,0,0,0,0,UAE
Olivier Gheysen,1800,200,0,0,0,0,0,UAE
Tomaz Kovacic,1800,200,0,0,0,0,0,Slovenia
Benoit Van Lee,1797.8252176865,167.960851461683,6,0,0,6,0,Belgium
Dimitris Vlachos,1789.88182873188,158.428620287626,6,0,0,6,0,Greece
Josef Skladanka,1788.85705086257,127.254108779758,12,0,0,12,0,Czech.Republic
Javier Pozo,1785.22009269191,165.303157878929,6,0,0,6,0,Spain
Paulo Morais,1784.5164707614,129.041616579198,11,1,0,10,6,Portugal
Albert Adolf,1776.81333987659,146.406929362201,11,0,0,11,6,Hungary
Shostak Dmytro,1770.91030209028,157.930936599501,6,0,0,6,6,Ukraine
Zeren Fang,1753.53880692364,151.203264355308,6,0,0,6,0,China
Chris Gill,1692.87828867129,161.096984884815,6,0,0,6,0,Northern.Ireland
